1111111111
1P00X00C01
1000000001
1000E00001
1111111111
