00000000000
0P000000000
001100C0110
101C0000CC0
11111111110
