NO ./imgs/north.png
SO ./imgs/south.png
WE ./imgs/west.png
EA ./imgs/east.png

F 220,100,0
C 225,30,0

1111111111111111111111111
1000000000110000000000001
1011000001110000000000001
1001000000000000000000001
1111111110110000011100001
1000000000110000011101111
1111011111011100000010001

1111011111111101110101001
1100000011010101110000001
1000000000000000110000001
10000000N0000000110101001
1100000111010101111101111
1111011111110101101111001
1111111111111111111111111
