111111111111111111
1C0000000C00000001
1011111111111110C1
100000000000000001
1C11110111110111C1
1000000P0000000001
1011111111111110C1
1000000E0000000001
1C0000000000000001
100000000000000001
10111C0000001C1001
111111111111111111
