1111111111111
1E000P00000C1
1111111111111
